"filename", "language", "HTML", "JavaScript", "JSON", "comment", "blank", "total"
"c:\Users\susuk\Documents\program\24_04_27bzb-pa-tool\controllers\admin.js", "JavaScript", 0, 70, 0, 0, 10, 80
"c:\Users\susuk\Documents\program\24_04_27bzb-pa-tool\controllers\auth.js", "JavaScript", 0, 80, 0, 3, 11, 94
"c:\Users\susuk\Documents\program\24_04_27bzb-pa-tool\controllers\bands.js", "JavaScript", 0, 95, 0, 0, 6, 101
"c:\Users\susuk\Documents\program\24_04_27bzb-pa-tool\controllers\lives.js", "JavaScript", 0, 46, 0, 0, 9, 55
"c:\Users\susuk\Documents\program\24_04_27bzb-pa-tool\controllers\myPages.js", "JavaScript", 0, 38, 0, 3, 5, 46
"c:\Users\susuk\Documents\program\24_04_27bzb-pa-tool\index.js", "JavaScript", 0, 105, 0, 7, 19, 131
"c:\Users\susuk\Documents\program\24_04_27bzb-pa-tool\middleware.js", "JavaScript", 0, 42, 0, 0, 7, 49
"c:\Users\susuk\Documents\program\24_04_27bzb-pa-tool\models\band.js", "JavaScript", 0, 39, 0, 0, 3, 42
"c:\Users\susuk\Documents\program\24_04_27bzb-pa-tool\models\live.js", "JavaScript", 0, 28, 0, 0, 3, 31
"c:\Users\susuk\Documents\program\24_04_27bzb-pa-tool\models\song.js", "JavaScript", 0, 46, 0, 0, 1, 47
"c:\Users\susuk\Documents\program\24_04_27bzb-pa-tool\models\user.js", "JavaScript", 0, 37, 0, 0, 5, 42
"c:\Users\susuk\Documents\program\24_04_27bzb-pa-tool\package-lock.json", "JSON", 0, 0, 1902, 0, 1, 1903
"c:\Users\susuk\Documents\program\24_04_27bzb-pa-tool\package.json", "JSON", 0, 0, 37, 0, 1, 38
"c:\Users\susuk\Documents\program\24_04_27bzb-pa-tool\routes\admin.js", "JavaScript", 0, 23, 0, 0, 8, 31
"c:\Users\susuk\Documents\program\24_04_27bzb-pa-tool\routes\auth.js", "JavaScript", 0, 15, 0, 8, 8, 31
"c:\Users\susuk\Documents\program\24_04_27bzb-pa-tool\routes\home.js", "JavaScript", 0, 6, 0, 0, 2, 8
"c:\Users\susuk\Documents\program\24_04_27bzb-pa-tool\routes\lives.js", "JavaScript", 0, 28, 0, 0, 9, 37
"c:\Users\susuk\Documents\program\24_04_27bzb-pa-tool\routes\myPage.js", "JavaScript", 0, 10, 0, 0, 2, 12
"c:\Users\susuk\Documents\program\24_04_27bzb-pa-tool\seeds\index.js", "JavaScript", 0, 27, 0, 0, 4, 31
"c:\Users\susuk\Documents\program\24_04_27bzb-pa-tool\utils\ExpressError.js", "JavaScript", 0, 8, 0, 0, 1, 9
"c:\Users\susuk\Documents\program\24_04_27bzb-pa-tool\utils\catchAsync.js", "JavaScript", 0, 5, 0, 0, 0, 5
"c:\Users\susuk\Documents\program\24_04_27bzb-pa-tool\utils\spotify_credentials.js", "JavaScript", 0, 27, 0, 0, 7, 34
"c:\Users\susuk\Documents\program\24_04_27bzb-pa-tool\utils\tempCodeRunnerFile.js", "JavaScript", 0, 1, 0, 0, 0, 1
"c:\Users\susuk\Documents\program\24_04_27bzb-pa-tool\views\admin\bandShow.ejs", "HTML", 20, 0, 0, 0, 0, 20
"c:\Users\susuk\Documents\program\24_04_27bzb-pa-tool\views\admin\index.ejs", "HTML", 44, 0, 0, 0, 1, 45
"c:\Users\susuk\Documents\program\24_04_27bzb-pa-tool\views\admin\liveIndex.ejs", "HTML", 26, 0, 0, 0, 1, 27
"c:\Users\susuk\Documents\program\24_04_27bzb-pa-tool\views\admin\liveManagement.ejs", "HTML", 30, 0, 0, 0, 0, 30
"c:\Users\susuk\Documents\program\24_04_27bzb-pa-tool\views\admin\liveShow.ejs", "HTML", 52, 0, 0, 0, 2, 54
"c:\Users\susuk\Documents\program\24_04_27bzb-pa-tool\views\admin\playlistShow.ejs", "HTML", 42, 0, 0, 0, 4, 46
"c:\Users\susuk\Documents\program\24_04_27bzb-pa-tool\views\admin\userManagement.ejs", "HTML", 23, 0, 0, 0, 0, 23
"c:\Users\susuk\Documents\program\24_04_27bzb-pa-tool\views\auth\login.ejs", "HTML", 27, 0, 0, 39, 0, 66
"c:\Users\susuk\Documents\program\24_04_27bzb-pa-tool\views\auth\new.ejs", "HTML", 39, 0, 0, 29, 0, 68
"c:\Users\susuk\Documents\program\24_04_27bzb-pa-tool\views\bands\edit.ejs", "HTML", 73, 0, 0, 0, 1, 74
"c:\Users\susuk\Documents\program\24_04_27bzb-pa-tool\views\bands\new.ejs", "HTML", 90, 0, 0, 0, 3, 93
"c:\Users\susuk\Documents\program\24_04_27bzb-pa-tool\views\bands\show.ejs", "HTML", 7, 0, 0, 0, 1, 8
"c:\Users\susuk\Documents\program\24_04_27bzb-pa-tool\views\errors\error.ejs", "HTML", 2, 0, 0, 0, 0, 2
"c:\Users\susuk\Documents\program\24_04_27bzb-pa-tool\views\errors\notFound.ejs", "HTML", 2, 0, 0, 0, 0, 2
"c:\Users\susuk\Documents\program\24_04_27bzb-pa-tool\views\home\index.ejs", "HTML", 20, 0, 0, 0, 2, 22
"c:\Users\susuk\Documents\program\24_04_27bzb-pa-tool\views\layouts\boilerplate.ejs", "HTML", 28, 0, 0, 0, 1, 29
"c:\Users\susuk\Documents\program\24_04_27bzb-pa-tool\views\lives\edit.ejs", "HTML", 46, 0, 0, 0, 2, 48
"c:\Users\susuk\Documents\program\24_04_27bzb-pa-tool\views\lives\index.ejs", "HTML", 24, 0, 0, 0, 1, 25
"c:\Users\susuk\Documents\program\24_04_27bzb-pa-tool\views\lives\new.ejs", "HTML", 45, 0, 0, 0, 2, 47
"c:\Users\susuk\Documents\program\24_04_27bzb-pa-tool\views\lives\show.ejs", "HTML", 34, 0, 0, 0, 3, 37
"c:\Users\susuk\Documents\program\24_04_27bzb-pa-tool\views\lives\show_admin.ejs", "HTML", 58, 0, 0, 0, 4, 62
"c:\Users\susuk\Documents\program\24_04_27bzb-pa-tool\views\myPage\index.ejs", "HTML", 74, 0, 0, 0, 5, 79
"c:\Users\susuk\Documents\program\24_04_27bzb-pa-tool\views\partials\editBandForm\song.ejs", "HTML", 39, 0, 0, 0, 0, 39
"c:\Users\susuk\Documents\program\24_04_27bzb-pa-tool\views\partials\editBandForm\songs.ejs", "HTML", 14, 0, 0, 0, 1, 15
"c:\Users\susuk\Documents\program\24_04_27bzb-pa-tool\views\partials\flash.ejs", "HTML", 11, 0, 0, 0, 1, 12
"c:\Users\susuk\Documents\program\24_04_27bzb-pa-tool\views\partials\navbar.ejs", "HTML", 37, 0, 0, 0, 1, 38
"c:\Users\susuk\Documents\program\24_04_27bzb-pa-tool\views\partials\newBandForm\song.ejs", "HTML", 39, 0, 0, 0, 0, 39
"c:\Users\susuk\Documents\program\24_04_27bzb-pa-tool\views\partials\newBandForm\songs.ejs", "HTML", 14, 0, 0, 0, 1, 15
"c:\Users\susuk\Documents\program\24_04_27bzb-pa-tool\views\partials\showBand\paTable.ejs", "HTML", 44, 0, 0, 0, 1, 45
"c:\Users\susuk\Documents\program\24_04_27bzb-pa-tool\views\partials\showBand\paTableSong.ejs", "HTML", 66, 0, 0, 0, 0, 66
"Total", "-", 1070, 776, 1939, 89, 160, 4034